width=20
height=15
1  1  1  1  1  1  1  1  1  1  1  1  1  1  1  1  1  1  1  1
1  0  0  0  0  0  0  0  0  0  0  0  0  0  0  0  0  0  0  1
1  0  0  0  0  0  0  0  0  0  0  0  0  0  0  0  0  0  0  1
1  0  0  0  0  0  0  0  0  0  0  0  0  0  0  0  0  0  0  1
1  0  0  0  0  0  0  0  0  0  0  0  0  0  0  0  0  0  0  1
1  0  0  0  0  0  0  0  0  0  0  0  0  0  0  0  0  0  0  1
7=2  8=1  0  0  0  0  0  0  0  0  0  0  0  0  0  0  0  0  0  1
1  0  0  0  0  0  0  0  0  0  0  0  0  0  0  0  0  0  0  1
1  0  6  0  0  0  0  0  0  0  0  0  0  0  0  0  0  0  0  1
1  0  0  0  0  0  0  0  0  0  0  0  0  0  0  0  0  0  0  1
1  1  4=0  1  1  1  0  0  0  0  0  0  0  0  0  0  0  0  0  1
1  0  0  0  0  1  0  0  0  0  0  0  0  0  0  0  0  0  0  1
1  0  2  0  3=0  1  0  0  0  0  0  0  0  0  0  0  0  0  0  1
1  8=2  0  0  0  1  0  0  0  0  0  0  0  0  0  0  0  0  0  1
1  7=1  1  1  1  1  1  1  1  1  1  1  1  1  1  1  1  1  1  1
