width=20
height=15
1  1  1  1  1  1  1  1  1  1  1  1  1  1  1  1  1  1  1  1
1  0  0  0  0  0  0  0  0  0  0  0  0  0  0  0  0  0  0  1
1  0  0  0  0  0  0  0  0  0  0  0  0  0  0  0  0  0  0  1
1  0  0  0  0  0  0  0  0  0  0  0  0  0  0  0  0  0  0  1
1  0  0  0  0  0  0  0  0  0  0  0  0  0  0  0  0  0  0  1
1  0  0  0  0  0  0  0  0  0  0  0  0  0  0  0  0  0  0  1
7=2  8=1  0  6  0  0  0  0  0  0  0  0  0  0  0  0  0  0  0  1
1  0  0  0  0  0  0  0  0  0  0  0  0  0  0  0  0  0  0  1
1  0  0  0  4=3  0  0  0  0  0  0  0  0  0  0  0  0  0  0  1
1  0  0  9=3  0  0  0 9=4  4=4,5  0  0  0  0  0  0  0  0  0  0  1
1  1  4=0  1  1  1  0 9=5  4=4,6  0  0  0  0  0  0  0  0  0  0  1
1  0  0  0  0  1  0  9=6  4=5,6  0  0  0  0  0  0  0  0  0  0  1
1  0  2  0  3=0  1  0  0  0  0  0  0  0  0  0  0  0  0  0  1
1  8=2  0  0  0  1  0  0  0  0  0  0  0  0  0  0  0  0  0  1
1  7=1  1  1  1  1  1  1  1  1  1  1  1  1  1  1  1  1  1  1
0 3 1
