width=20
height=15
1   1   1  1    1   1   1  1  1  1  1  1  1  7=2  1  1  1  1  1  1
1   0   0  0    0   1   1  0  0  0  0  1  1  8=4  0  0  6  1  1  1
1   0   2  0    0   1   1  0  0  0  0  1  1  0    0  0  0  1  1  1
1   0   0  3=1  0   1   1  0  0  0  0  1  1  0    0  0  0  1  1  1
1   0   0  0    0   1   1  0  0  0  0  1  1  1    1  1  1  1  1  1
1   1   1  4=1  1   1   1  0  0  0  0  1  1  1    1  1  1  1  1  1
1   0   0  0    0   1   1  0  0  0  0  0  0  0    0  0  0  0  0  1
7=2 8=3 0  0    0   7=5 1  0  0  0  0  0  0  0    0  0  0  0  0  1
1   0   0  0    0   1   1  0  0  0  0  0  0  0    0  0  0  0  0  1
7=3 8=5 0  0    8=2 7=4 1  0  0  0  0  0  0  0    0  0  0  0  0  1
1   0   0  0    0   1   1  0  0  0  0  0  0  0    0  0  0  0  0  1
1   1   1  1    1   1   1  0  0  0  0  0  0  0    0  0  0  0  0  1
1   1   1  1    1   1   1  0  0  0  0  0  0  0    0  0  0  0  0  1
1   0   0  0    0   0   0  0  0  0  0  0  0  0    0  0  0  0  0  1
1   1   1  1    1   1   1  1  1  1  1  1  1  1    1  1  1  1  1  1
