width=31
height=24
1  1  1  1  1   1   1  1  1    1  1  1    1     1    1  1     1    1  1  1    1  1  1  1  1  1  1  1  1    1    1    1
1  1  1  1  1   1   1  1  1    1  1  1    0     0    0  0     0    0  0  0    0  0  0  0  0  0  0  0  0    0    1    1
1  1  1  1  1   1   1  1  1    1  1  1    0     0    0  0     0    0  0  0    0  0  0  0  0  0  0  0  0    8=8  1    1
1  1  1  1  1   1   1  1  1    1  1  1    0     0    0  1     1    1  1  0    1  1  1  1  1  1  1  1  1    7=6  1    1
1  1  1  1  1   1   1  1  1    1  1  1    0     0    0  0     0    1  1  8=4  1  1  1  1  1  1  1  1  1    1    1    1
1  0  0  0  1   0   0  0  0    0  0  1    0     0    0  0     0    1  1  7=5  1  1  1  1  1  1  1  1  1    1    1    1
1  0  0  0  4=1 0   0  0  0    0  0  1    1     1    1  1     1    1  1  1    1  1  1  1  1  1  1  1  1    1    1    1
1  0  0  0  1   0   0  0  3=3  0  0  1    0     0    0  0     0    0  0  0    0  0  0  0  0  0  0  0  0    0    1    1
1  1  1  1  1   0   0  0  0    8=11  0  4=3     0    0  0     0    0  0  0    0  0  0  0  0  0  0  0  0    0    8=10 7=9
1  0  0  0  0   0   0  0  0    0  0  1    0     0    0  0     0    0  0  0    0  0  0  0  0  0  0  0  0    0    1    1
1  0  0  0  0   0   0  0  0    0  0  1    1     1    1  1     1    1  1  1    1  1  1  1  0  0  0  1  1    1    1    1
1  0  0  0  0   0   0  0  0    0  0  1    1     1    1  1     1    1  1  7=4  1  1  1  1  0  0  0  1  1    7=8  1    1
1  0  0  0  0   0   0  0  0    0  0  1    1     0    0  0     1    1  0  8=5  0  1  1  1  0  0  0  1  1    8=6  0    1
1  0  0  0  0   0   0  0  0    0  0  1    7=10  8=9  0  0     7=11 1  0  0    0  1  1  1  0  0  0  1  1    0    0    1
1  0  0  0  0   0   0  0  0    0  0  1    1     0    0  0     1    1  0  0    0  0  0  0  0  0  0  1  1    0    0    1
1  0  0  0  0   0   0  0  0    0  0  1    1     0    0  8=13  7=12 1  0  0    0  0  0  0  0  0  0  1  1    0    0    1
1  0  0  0  0   0   0  0  0    0  0  1    1     0    0  0     1    1  0  0    0  0  0  0  0  0  0  1  1    0    0    1
1  0  0  0  0   0   0  0  0    0  0  1    1     1    1  1     1    1  1  1    1  1  1  1  1  1  1  1  1    0    0    1
1  0  0  0  0   0   0  0  0    0  0  1    1     1    1  1     1    1  1  1    1  1  1  1  1  1  0  0  0    0    0    1
1  0  0  0  0   0   0  0  0    0  0  1    1     0    0  0     0    0  0  0    0  0  0  0  0  1  0  0  0    0    0    1
1  0  0  0  0   0   0  0  0    0  0  1    7=13  8=12 0  0     0    0  0  0    0  0  0  0  0  1  0  0  0    0    0    1
1  0  2  0  0   0   0  0  0    0  0  1    1     0    0  0     0    0  0  0    0  0  0  0  0  1  0  0  3=1  0    0    1
1  0  0  0  0   8=2 0  0  0    0  0  1    1     1    1  1     1    1  1  1    1  1  1  1  1  1  0  0  0    0    0    1
1  1  1  1  1   1   1  1  1    1  1  1    1     1    1  1     1    1  1  1    1  1  1  1  1  1  1  1  7=2  1    1    1
