width=20
height=5
1 1 1 1 1    1 1 1     1 1    1 1 1     1    1 1     1     1 1 1 1
1 0 0 0 0    0 0 4=1   0 0    0 4=1,2,3 0    0 1     1     0 0 0 1
1 0 2 0 9=1  0 0 1     0 9=2  0 1 0     9=3  0 5=3,2 4=3   0 6 0 1
1 0 0 0 0    0 0 5=1,2 0 0    0 4=3,2   0    0 1     1     0 0 0 1
1 1 1 1 1    1 1 1     1 1    1 1 1     1    1 1     1     1 1 1 1
0 3 2
0 3 4